80x44
________________________________________________________________________________
________________________________________________________________________________
________________________________________________________________________________
________________________________________________________________________________
______________________________________X_________________________________________
________________________________________________________________________________
XXXXXXXXXXXXXXXXXXXXXXXXXXXXXXXXXXXXXXXXXXXXXXXXXXXXXXXXXXXXXXXXXXXXXXXXXXXXXXXX
X______________________________________________________________________________X
X______________________________________________________________________________X
X______________________________________________________________________________X
X______________________________________________________________________________X
X______________________________________________________________________________X
X______________________________________________________________________________X
X______________________________________________________________________________X
X______________________________________________________________________________X
X______________________________________________________________________________X
X______________________________________________________________________________X
X______________________________________________________________________________X
X______________________________________________________________________________X
X______________________________________________________________________________X
X______________________________________________________________________________X
X______________________________________________________________________________X
X______________________________________________________________________________X
X______________________________________________________________________________X
X______________________________________________________________________________X
X______________________________________________________________________________X
X______________________________________________________________________________X
X______________________________________________________________________________X
X______________________________________________________________________________X
X______________________________________________________________________________X
X______________________________________________________________________________X
X______________________________________________________________________________X
X______________________________________________________________________________X
X______________________________________________________________________________X
X______________________________________________________________________________X
X______________________________________________________________________________X
X______________________________________________________________________________X
X______________________________________________________________________________X
X______________________________________________________________________________X
X______________________________________________________________________________X
X______________________________________________________________________________X
X______________________________________________________________________________X
XXXXXXXXXXXXXXXXXXXXXXXXXXXXXXXXXXXXXXXXXXXXXXXXXXXXXXXXXXXXXXXXXXXXXXXXXXXXXXXX